111111111111111111111111111
1100010000000000000000000E1
101010000000000000000000101
1001000000CC000000000001101
1000000000CC000000000011101
100000000000000000000111101
100000000000000000001111101
100000000000000000011111101
1C00000000000000P01111111C1
111111111111111111111111111
