11111111111111111111111111111
11110000000000000000000001111
11100011000110001111111000111
11000011CCC110001111111000011
10000011CEC110000000011000001
10000011CCC110000000011000001
10000011000110P00000011000001
10000011111110001111111000001
10000011111110001100000000001
1000000000011000110C000000001
1000000000011000110C000000001
10000000000110001111111000001
11000000000110001111111000011
11100000000000000000000000111
11110000000000000000000001111
11111111111111111111111111111
