11111111111
1qwertyuil1
10000000001
1CEP0000001
11111111111
